...........v.v..
.........******.
..*.....*....&..
.....****f*****.
....*........&..
..*f*f*****f***.
.*kkkkkkkkkkkkk.
