................
...*..*..*......
...........*....
....*.*..*......
..*...*.........
....*.*.........
..*.&.....&....&
