...@............
...*..*..*......
...........*....
....*.*..*......
..*...*......***
....*.*.........
..*............o
