.....&&&...@....
....*ff**..*&@*.
..*.&&&....*&&*.
...**ff*..&*&@*.
....&&&..*.*&.&.
...**ff*@..*....
..*kkkkkvkkkk.v.
