................
...*..*..*......
...........*....
....*.*..*......
..*...**********
....*.*@@@@@@@@@
..*@@@@@@@@@@@@@
