................
.......v&v....@v
&@.v..******..*v
&*f**...*k@..f.v
....&&*@*****...
...***@*..&.....
..*p&...&...v..o
