................
................
................
................
...l..m..h..e...
................
.w............r.
