................
...<>>>>>>>>>...
................
...!........$...
................
................
.w............r.
