................
................
................
................
...d..d..d..d...
................
.w............r.
