................
................
................
................
...b..i..g..p...
................
.w............r.
