................
...<>>>>>>>>>...
................
...$........!...
................
................
.w............r.
